-----------------
-...........####-
-....#.........#-
-###.########.##-
-..#.....#....#.-
-..#.#######.##.-
-.##............-
-..##.##.#####..-
-.....#.........-
-..#.###.#####..-
-.##......#.....-
-..###.##.#.##..-
-..#.....>...##.-
-.###....##...#.-
-.....#...#...#.-
-.#####...###.##-
-----------------
