-----------------
-..###.....###..-
-...............-
-...............-
-...##.....##...-
-...##.....##...-
-...............-
-.#.....#....#..-
-...#...>#......-
-.......#..#....-
-.##.........##.-
-...##......##..-
-.....######....-
-..#.........#..-
-...#.......#...-
-....#######....-
-----------------