-----------------
-#........#....#-
-..........#.#..-
-.......#.......-
-...............-
-.#.........#.#.-
-#...........#.#-
-......#....#...-
-#.....>....#..#-
-........#..#...-
-#.#.....#.#.#.#-
-...............-
-...............-
-...........#.#.-
-#.............#-
-##...#.#.#...##-
-----------------