-----------------
-...............-
-...............-
-...#########...-
-...............-
-...########....-
-...............-
-...########....-
-............>..-
-...............-
-..#.#.#.#.#.#..-
-..#.#.#.#.#.#..-
-..#.#.#.#.#.#..-
-..#.#.#.#.#.#..-
-...............-
-...............-
-----------------