-----------------
-...............-
-...............-
-...#....#....#.-
-...#....#....#.-
-...#....#....#.-
-...#....#..>.#.-
-...#....#....#.-
-...............-
-...............-
-.#..#..#..#....-
-.#..#..#..#....-
-.#........#....-
-.#........#....-
-...............-
-...............-
-----------------