-----------------
--#.#.#.#.#.....-
-............#.#-
-............#.#-
-............#.#-
-..............#-
-.....########.#-
-............#.#-
-............#.#-
-............#.#-
-............#.#-
-.#.#.#.#.#.#..#-
-............#.#-
-.#.#.#.#.#....#-
-............#.#-
-............#.#-
-----------------